Gene	Class
AARS	Hsap_Spec_UpReg
ABCF2	Hsap_Spec_UpReg
ACSL6	Hsap_Spec_UpReg
ADAM19	Hsap_Spec_UpReg
AK2	Hsap_Spec_UpReg
AKT1	Hsap_Spec_UpReg
AMPD3	Hsap_Spec_UpReg
ANKRD6	Hsap_Spec_UpReg
AP3B1	Hsap_Spec_UpReg
APP	Hsap_Spec_UpReg
ARHGAP10	Hsap_Spec_UpReg
ARHGEF12	Hsap_Spec_UpReg
ARHGEF26	Hsap_Spec_UpReg
ARID4A	Hsap_Spec_UpReg
ASCL1	Hsap_Spec_UpReg
ASPH	Hsap_Spec_UpReg
ATAD2B	Hsap_Spec_UpReg
ATP1B1	Hsap_Spec_UpReg
ATP2B4	Hsap_Spec_UpReg
ATP8A1	Hsap_Spec_UpReg
BAZ1B	Hsap_Spec_UpReg
BCAS1	Hsap_Spec_UpReg
BCAT1	Hsap_Spec_UpReg
BCL7A	Hsap_Spec_UpReg
BDH1	Hsap_Spec_UpReg
BEST1	Hsap_Spec_UpReg
BICD1	Hsap_Spec_UpReg
BLZF1	Hsap_Spec_UpReg
BRD8	Hsap_Spec_UpReg
C19orf18	Hsap_Spec_UpReg
C1orf35	Hsap_Spec_UpReg
C20orf96	Hsap_Spec_UpReg
C7orf55-LUC7L2	Hsap_Spec_UpReg
CADM3	Hsap_Spec_UpReg
CALCOCO2	Hsap_Spec_UpReg
CAMK1D	Hsap_Spec_UpReg
CAMK2G	Hsap_Spec_UpReg
CCDC136	Hsap_Spec_UpReg
CCDC174	Hsap_Spec_UpReg
CCDC30	Hsap_Spec_UpReg
CCDC62	Hsap_Spec_UpReg
CCDC91	Hsap_Spec_UpReg
CCSAP	Hsap_Spec_UpReg
CDC40	Hsap_Spec_UpReg
CDC5L	Hsap_Spec_UpReg
CDC73	Hsap_Spec_UpReg
CDK11A	Hsap_Spec_UpReg
CDK5RAP2	Hsap_Spec_UpReg
CES2	Hsap_Spec_UpReg
CFDP1	Hsap_Spec_UpReg
CHD6	Hsap_Spec_UpReg
CIR1	Hsap_Spec_UpReg
CLNS1A	Hsap_Spec_UpReg
CMTR1	Hsap_Spec_UpReg
CMYA5	Hsap_Spec_UpReg
CNOT3	Hsap_Spec_UpReg
CNST	Hsap_Spec_UpReg
CNTRL	Hsap_Spec_UpReg
COG5	Hsap_Spec_UpReg
COL18A1	Hsap_Spec_UpReg
COX15	Hsap_Spec_UpReg
CTNNA2	Hsap_Spec_UpReg
CTR9	Hsap_Spec_UpReg
CTTN	Hsap_Spec_UpReg
CWC15	Hsap_Spec_UpReg
CWF19L2	Hsap_Spec_UpReg
DDX10	Hsap_Spec_UpReg
DDX23	Hsap_Spec_UpReg
DHX38	Hsap_Spec_UpReg
DIP2C	Hsap_Spec_UpReg
DIXDC1	Hsap_Spec_UpReg
DNAJB6	Hsap_Spec_UpReg
DNAJC2	Hsap_Spec_UpReg
DOCK1	Hsap_Spec_UpReg
DPF3	Hsap_Spec_UpReg
DYNC1I2	Hsap_Spec_UpReg
DZIP1	Hsap_Spec_UpReg
EHBP1L1	Hsap_Spec_UpReg
EIF2D	Hsap_Spec_UpReg
EIF2S2	Hsap_Spec_UpReg
EIF3G	Hsap_Spec_UpReg
EIF5	Hsap_Spec_UpReg
EIF5B	Hsap_Spec_UpReg
ENC1	Hsap_Spec_UpReg
ENDOV	Hsap_Spec_UpReg
ERC1	Hsap_Spec_UpReg
FAM114A1	Hsap_Spec_UpReg
FAM184B	Hsap_Spec_UpReg
FEZ1	Hsap_Spec_UpReg
FEZ2	Hsap_Spec_UpReg
FRA10AC1	Hsap_Spec_UpReg
GIGYF2	Hsap_Spec_UpReg
GIPR	Hsap_Spec_UpReg
GNAQ	Hsap_Spec_UpReg
GPATCH1	Hsap_Spec_UpReg
GPHN	Hsap_Spec_UpReg
GSN	Hsap_Spec_UpReg
GTF2F1	Hsap_Spec_UpReg
GTF2IRD1	Hsap_Spec_UpReg
HAP1	Hsap_Spec_UpReg
HDAC2	Hsap_Spec_UpReg
HINT3	Hsap_Spec_UpReg
HNRNPR	Hsap_Spec_UpReg
HSP90B1	Hsap_Spec_UpReg
IGFN1	Hsap_Spec_UpReg
IL17RB	Hsap_Spec_UpReg
INO80E	Hsap_Spec_UpReg
INPP4B	Hsap_Spec_UpReg
ITSN1	Hsap_Spec_UpReg
ITSN2	Hsap_Spec_UpReg
JUND	Hsap_Spec_UpReg
KCNAB1	Hsap_Spec_UpReg
KIAA1217	Hsap_Spec_UpReg
KIF16B	Hsap_Spec_UpReg
KRCC1	Hsap_Spec_UpReg
KRI1	Hsap_Spec_UpReg
L3MBTL3	Hsap_Spec_UpReg
LARS	Hsap_Spec_UpReg
LARS2	Hsap_Spec_UpReg
LENG1	Hsap_Spec_UpReg
LEO1	Hsap_Spec_UpReg
LETM1	Hsap_Spec_UpReg
LIMA1	Hsap_Spec_UpReg
LIMCH1	Hsap_Spec_UpReg
LRP2BP	Hsap_Spec_UpReg
LRRK2	Hsap_Spec_UpReg
LUC7L3	Hsap_Spec_UpReg
LYAR	Hsap_Spec_UpReg
MAP3K5	Hsap_Spec_UpReg
MATN2	Hsap_Spec_UpReg
MCM8	Hsap_Spec_UpReg
MED4	Hsap_Spec_UpReg
MICU1	Hsap_Spec_UpReg
MPHOSPH9	Hsap_Spec_UpReg
MROH7	Hsap_Spec_UpReg
MTDH	Hsap_Spec_UpReg
MXI1	Hsap_Spec_UpReg
MYO10	Hsap_Spec_UpReg
MYO6	Hsap_Spec_UpReg
MYO7A	Hsap_Spec_UpReg
NAA15	Hsap_Spec_UpReg
NAP1L4	Hsap_Spec_UpReg
NAPB	Hsap_Spec_UpReg
NCOR1	Hsap_Spec_UpReg
NEBL	Hsap_Spec_UpReg
NEFH	Hsap_Spec_UpReg
NEMF	Hsap_Spec_UpReg
NLK	Hsap_Spec_UpReg
NOP14	Hsap_Spec_UpReg
NRXN3	Hsap_Spec_UpReg
NUCKS1	Hsap_Spec_UpReg
NUP43	Hsap_Spec_UpReg
NVL	Hsap_Spec_UpReg
OARD1	Hsap_Spec_UpReg
OS9	Hsap_Spec_UpReg
OXCT1	Hsap_Spec_UpReg
PACSIN2	Hsap_Spec_UpReg
PALLD	Hsap_Spec_UpReg
PAXBP1	Hsap_Spec_UpReg
PAXIP1	Hsap_Spec_UpReg
PCNT	Hsap_Spec_UpReg
PCSK5	Hsap_Spec_UpReg
PCSK7	Hsap_Spec_UpReg
PDE8B	Hsap_Spec_UpReg
PELP1	Hsap_Spec_UpReg
PES1	Hsap_Spec_UpReg
PFDN4	Hsap_Spec_UpReg
PFKL	Hsap_Spec_UpReg
PHF20	Hsap_Spec_UpReg
PLCB1	Hsap_Spec_UpReg
PLCB3	Hsap_Spec_UpReg
POLR3GL	Hsap_Spec_UpReg
PON2	Hsap_Spec_UpReg
POR	Hsap_Spec_UpReg
PPFIA1	Hsap_Spec_UpReg
PPIG	Hsap_Spec_UpReg
PPP1R12A	Hsap_Spec_UpReg
PPP1R21	Hsap_Spec_UpReg
PPWD1	Hsap_Spec_UpReg
PRDX6	Hsap_Spec_UpReg
PRKAR1A	Hsap_Spec_UpReg
PRPF31	Hsap_Spec_UpReg
PRPF38B	Hsap_Spec_UpReg
PRPF6	Hsap_Spec_UpReg
PRRC2C	Hsap_Spec_UpReg
PSIP1	Hsap_Spec_UpReg
PSMC3	Hsap_Spec_UpReg
PTCD3	Hsap_Spec_UpReg
PTN	Hsap_Spec_UpReg
PTPRM	Hsap_Spec_UpReg
RAD21	Hsap_Spec_UpReg
RASGEF1B	Hsap_Spec_UpReg
RASSF4	Hsap_Spec_UpReg
RBM17	Hsap_Spec_UpReg
RBM25	Hsap_Spec_UpReg
RBM27	Hsap_Spec_UpReg
RHOBTB1	Hsap_Spec_UpReg
ROCK1	Hsap_Spec_UpReg
RSRC1	Hsap_Spec_UpReg
RSRC2	Hsap_Spec_UpReg
RTF1	Hsap_Spec_UpReg
RUFY1	Hsap_Spec_UpReg
RYR2	Hsap_Spec_UpReg
SAFB2	Hsap_Spec_UpReg
SART1	Hsap_Spec_UpReg
SART3	Hsap_Spec_UpReg
SASH1	Hsap_Spec_UpReg
SCLT1	Hsap_Spec_UpReg
SEC62	Hsap_Spec_UpReg
SETD4	Hsap_Spec_UpReg
SF3A3	Hsap_Spec_UpReg
SFPQ	Hsap_Spec_UpReg
SFSWAP	Hsap_Spec_UpReg
SGIP1	Hsap_Spec_UpReg
SLC6A15	Hsap_Spec_UpReg
SLCO1A2	Hsap_Spec_UpReg
SMARCA4	Hsap_Spec_UpReg
SMARCA5	Hsap_Spec_UpReg
SMARCC1	Hsap_Spec_UpReg
SMARCC2	Hsap_Spec_UpReg
SMIM14	Hsap_Spec_UpReg
SNAP25	Hsap_Spec_UpReg
SNW1	Hsap_Spec_UpReg
SOGA3	Hsap_Spec_UpReg
SOX5	Hsap_Spec_UpReg
SOX9	Hsap_Spec_UpReg
SPARC	Hsap_Spec_UpReg
SPIRE2	Hsap_Spec_UpReg
SREK1	Hsap_Spec_UpReg
SRFBP1	Hsap_Spec_UpReg
SRRT	Hsap_Spec_UpReg
SRSF11	Hsap_Spec_UpReg
SSRP1	Hsap_Spec_UpReg
STAG1	Hsap_Spec_UpReg
SUPT5H	Hsap_Spec_UpReg
SUPT6H	Hsap_Spec_UpReg
TAF3	Hsap_Spec_UpReg
TATDN3	Hsap_Spec_UpReg
TCF12	Hsap_Spec_UpReg
TCF25	Hsap_Spec_UpReg
TCHP	Hsap_Spec_UpReg
TDRD3	Hsap_Spec_UpReg
TEAD1	Hsap_Spec_UpReg
TFIP11	Hsap_Spec_UpReg
TGS1	Hsap_Spec_UpReg
THAP6	Hsap_Spec_UpReg
THOC5	Hsap_Spec_UpReg
TIAM1	Hsap_Spec_UpReg
TIMELESS	Hsap_Spec_UpReg
TMEM150C	Hsap_Spec_UpReg
TMOD2	Hsap_Spec_UpReg
TNS1	Hsap_Spec_UpReg
TOP1	Hsap_Spec_UpReg
TOP2B	Hsap_Spec_UpReg
TPM2	Hsap_Spec_UpReg
TPM4	Hsap_Spec_UpReg
TRAF3IP1	Hsap_Spec_UpReg
TRIM24	Hsap_Spec_UpReg
TRIM44	Hsap_Spec_UpReg
TRPM3	Hsap_Spec_UpReg
TRUB1	Hsap_Spec_UpReg
TUBGCP5	Hsap_Spec_UpReg
TXNDC9	Hsap_Spec_UpReg
UBE2K	Hsap_Spec_UpReg
UBTF	Hsap_Spec_UpReg
UBXN4	Hsap_Spec_UpReg
UPF2	Hsap_Spec_UpReg
UPF3A	Hsap_Spec_UpReg
USP37	Hsap_Spec_UpReg
UTP23	Hsap_Spec_UpReg
UVRAG	Hsap_Spec_UpReg
VRK2	Hsap_Spec_UpReg
WDR43	Hsap_Spec_UpReg
WDR70	Hsap_Spec_UpReg
XPA	Hsap_Spec_UpReg
XPC	Hsap_Spec_UpReg
YAP1	Hsap_Spec_UpReg
YTHDC1	Hsap_Spec_UpReg
ZC3H18	Hsap_Spec_UpReg
ZEB1	Hsap_Spec_UpReg
ZFR	Hsap_Spec_UpReg
ZMAT2	Hsap_Spec_UpReg
ZNF276	Hsap_Spec_UpReg
ZNF552	Hsap_Spec_UpReg
ZRANB1	Hsap_Spec_UpReg
ABCC10	Hsap_Spec_DownReg
ABHD6	Hsap_Spec_DownReg
ACADSB	Hsap_Spec_DownReg
AGO1	Hsap_Spec_DownReg
AGPAT5	Hsap_Spec_DownReg
AMBRA1	Hsap_Spec_DownReg
ANKAR	Hsap_Spec_DownReg
ARHGAP33	Hsap_Spec_DownReg
ARHGAP35	Hsap_Spec_DownReg
ARID1B	Hsap_Spec_DownReg
ARID2	Hsap_Spec_DownReg
B4GALT3	Hsap_Spec_DownReg
BACH2	Hsap_Spec_DownReg
BTBD3	Hsap_Spec_DownReg
C6orf136	Hsap_Spec_DownReg
CARD8	Hsap_Spec_DownReg
CARM1	Hsap_Spec_DownReg
CLDN11	Hsap_Spec_DownReg
COBL	Hsap_Spec_DownReg
CPPED1	Hsap_Spec_DownReg
CPSF4	Hsap_Spec_DownReg
CSAD	Hsap_Spec_DownReg
CSF1	Hsap_Spec_DownReg
DDX39B	Hsap_Spec_DownReg
DHFR	Hsap_Spec_DownReg
DLC1	Hsap_Spec_DownReg
DMWD	Hsap_Spec_DownReg
DNMBP	Hsap_Spec_DownReg
DPH1	Hsap_Spec_DownReg
DTHD1	Hsap_Spec_DownReg
DVL3	Hsap_Spec_DownReg
EFS	Hsap_Spec_DownReg
EIF2B1	Hsap_Spec_DownReg
ELMO2	Hsap_Spec_DownReg
EXT2	Hsap_Spec_DownReg
EXTL3	Hsap_Spec_DownReg
FAM160A2	Hsap_Spec_DownReg
FAM171B	Hsap_Spec_DownReg
FAM214A	Hsap_Spec_DownReg
FGFR2	Hsap_Spec_DownReg
FNIP2	Hsap_Spec_DownReg
FOXO1	Hsap_Spec_DownReg
FURIN	Hsap_Spec_DownReg
GANC	Hsap_Spec_DownReg
GAS7	Hsap_Spec_DownReg
GCLC	Hsap_Spec_DownReg
GEMIN4	Hsap_Spec_DownReg
GLIPR2	Hsap_Spec_DownReg
GNPAT	Hsap_Spec_DownReg
GOLGA7	Hsap_Spec_DownReg
GRIK5	Hsap_Spec_DownReg
GRINA	Hsap_Spec_DownReg
GSTP1	Hsap_Spec_DownReg
H6PD	Hsap_Spec_DownReg
HEATR1	Hsap_Spec_DownReg
HECW2	Hsap_Spec_DownReg
HGSNAT	Hsap_Spec_DownReg
HIVEP3	Hsap_Spec_DownReg
HYAL2	Hsap_Spec_DownReg
ICK	Hsap_Spec_DownReg
IGSF11	Hsap_Spec_DownReg
IKZF4	Hsap_Spec_DownReg
ITGB8	Hsap_Spec_DownReg
KCNK1	Hsap_Spec_DownReg
KIAA0355	Hsap_Spec_DownReg
KLHL32	Hsap_Spec_DownReg
LATS2	Hsap_Spec_DownReg
LRRTM2	Hsap_Spec_DownReg
MAML2	Hsap_Spec_DownReg
MFSD6	Hsap_Spec_DownReg
MTMR2	Hsap_Spec_DownReg
MYO19	Hsap_Spec_DownReg
NBEAL1	Hsap_Spec_DownReg
NCOA6	Hsap_Spec_DownReg
NDST1	Hsap_Spec_DownReg
NF1	Hsap_Spec_DownReg
NIPBL	Hsap_Spec_DownReg
NOD1	Hsap_Spec_DownReg
NUP214	Hsap_Spec_DownReg
OMG	Hsap_Spec_DownReg
OSGIN1	Hsap_Spec_DownReg
P4HTM	Hsap_Spec_DownReg
PANX1	Hsap_Spec_DownReg
PCDH9	Hsap_Spec_DownReg
PCDHB15	Hsap_Spec_DownReg
PDE8A	Hsap_Spec_DownReg
PDLIM3	Hsap_Spec_DownReg
PDZD7	Hsap_Spec_DownReg
PHC1	Hsap_Spec_DownReg
PI4KB	Hsap_Spec_DownReg
PLEKHA7	Hsap_Spec_DownReg
PPM1B	Hsap_Spec_DownReg
PPP2R3A	Hsap_Spec_DownReg
PRRC2A	Hsap_Spec_DownReg
PTCH1	Hsap_Spec_DownReg
PTPRD	Hsap_Spec_DownReg
PTRH1	Hsap_Spec_DownReg
PURB	Hsap_Spec_DownReg
QRICH1	Hsap_Spec_DownReg
QSER1	Hsap_Spec_DownReg
RAD23A	Hsap_Spec_DownReg
RAPGEF5	Hsap_Spec_DownReg
RBM12	Hsap_Spec_DownReg
RPS6KA1	Hsap_Spec_DownReg
RTN4	Hsap_Spec_DownReg
SALL1	Hsap_Spec_DownReg
SCAF4	Hsap_Spec_DownReg
SCAMP2	Hsap_Spec_DownReg
SHF	Hsap_Spec_DownReg
SLC22A17	Hsap_Spec_DownReg
SLC38A7	Hsap_Spec_DownReg
SLC44A2	Hsap_Spec_DownReg
SLC9A8	Hsap_Spec_DownReg
SLITRK5	Hsap_Spec_DownReg
SMG1	Hsap_Spec_DownReg
SNX14	Hsap_Spec_DownReg
SP2	Hsap_Spec_DownReg
ST18	Hsap_Spec_DownReg
STIL	Hsap_Spec_DownReg
SZT2	Hsap_Spec_DownReg
TCAP	Hsap_Spec_DownReg
TET2	Hsap_Spec_DownReg
TIAL1	Hsap_Spec_DownReg
TM7SF2	Hsap_Spec_DownReg
TMEM131	Hsap_Spec_DownReg
TMEM132B	Hsap_Spec_DownReg
TONSL	Hsap_Spec_DownReg
TRIP12	Hsap_Spec_DownReg
TRPT1	Hsap_Spec_DownReg
TTC30A	Hsap_Spec_DownReg
TUBB4A	Hsap_Spec_DownReg
URM1	Hsap_Spec_DownReg
USP19	Hsap_Spec_DownReg
USP31	Hsap_Spec_DownReg
USPL1	Hsap_Spec_DownReg
VPS52	Hsap_Spec_DownReg
WBP1	Hsap_Spec_DownReg
WBP1L	Hsap_Spec_DownReg
WDR20	Hsap_Spec_DownReg
WDR33	Hsap_Spec_DownReg
WDR62	Hsap_Spec_DownReg
WIPI2	Hsap_Spec_DownReg
ZBED5	Hsap_Spec_DownReg
ZFHX4	Hsap_Spec_DownReg
ZFYVE1	Hsap_Spec_DownReg
ZFYVE16	Hsap_Spec_DownReg
ZKSCAN8	Hsap_Spec_DownReg
ZNF181	Hsap_Spec_DownReg
ZNF251	Hsap_Spec_DownReg
ZNF460	Hsap_Spec_DownReg
ZNF549	Hsap_Spec_DownReg
ZNF555	Hsap_Spec_DownReg
ZNF644	Hsap_Spec_DownReg
ZNF746	Hsap_Spec_DownReg
ZNF792	Hsap_Spec_DownReg
